Accuracy = трапнасць
Achievements = Дасягненьні
Adepta Sororitas = Адэпта Сарорытас
Adeptus Astartes = Адэптус Астартэс
Adeptus Mechanicus = Адэптус Механікус
Advanced = Пашыраныя
Aeldari = Аэльдары
agenda = мэта
AI = ШІ
Artefact = Артэфакт
Astra Militarum = Астра Мілітарум
Asuryan = Асур'ян
Asuryani = Асур'яны (народ, дзеці Асур'яна)
Asuryani Arrivals = Заклік Асур'яна
Attributes = Уласьцівасьці
Bark = Дыялог
Basic = Асноўныя
Black Library = Чорнай Бібліятэцы
Blaster = бластар
Blood Angels = Крывавых Анёлаў 
Boon = Дарунак
Broken = зламаны
C'tan = К'тан
Cadia = Кадыя
Cannon = гармата
Canticles of the Omnissiah = Сьпевы Амнісіі
Celestine = Сэлесьціна
ceramite = керамітны
Chapter = ордэн
Chapter = Падзел
Charges = Зарады
Commander Surestrike = Камандар
Cooldown = Час перазарадкі
Cover = хованка
Craftworlds = Штучны Сьвет
Crownworld = Каронным Сьвеце
Dark Angels = Цёмных Ангелаў
Deceiver = Ашуканца
Departmento Munitorum = Дэпартамент Муніторум
Doctrina Imperatives = Дактрына Імператыў
Drukhari = Друкхары
Ecclesiarchy = Экклезіархія
Edicts = Эдыкт
Eldar = Аэльдары
Emperor’s Will = Воляй Імператара
Exodites = Экзадзіты
Eye of Terror = Вока Жаху
False Emperor = ілжэімператар (сагласн.) лжэімператар (галос.)
Features = Мясцовасць
For The Greater Good = Ў Імя Найвысокага Дабрата
gene-seed = генасемя
Genetor - генетар
Gladius Prime = Гладыус Прайм
God-Emperor = Богу-Імператару
Golden Throne = Залаты Трон
Great Devourer = Вялікі Пажыральнік
Great Rift = Вялікі Разлом
Greater Good = Найвысокае Дабрата
Grot = Грот
Gun = Пушка
Gunship = Карабель
Harlequins = Арлекіны
Hitpoints = Здароўе
Hive Cities = Гарадоў-Вульляў
Hive Mind = Розуму Вульля
Imperium = Імперыум
Item = Прадмет
Khaine = Кхайн
LifeLeech = Паглынальнік Жыцьця
Loyalty = лаяльнасць
Maelstrom = Вір
Mark of Nurgle = Пазнака Нургла.
Marks of Chaos = Пазнака Хаосу
Melta = Мельта
Might Makes Right = Моц Дае Права
Mob = Моб
Mont’yhe’va Devourer of Hope = Монт'ай'ва Паглынальнік Надзеі
Morale = мараль
Movement = рух
Necrons = Некроны
Neutral = Нейтрал
Objectives = Мэты
Old Ones = Старажытныя
Omnissiah = Амнісія
Omnissiah = Амнісія
Operations = Загады
Ordnance = Артылерыя
Ordo Malleus = Орда Мальлеўс
Orks = Оркі
Pinning = скоўваньня
Player = гулец
Primaris = Прымарыс
RailRifle = рэйка стрэльба
Random = Выпадковая
Rewards = Узнагароды
Rifle = стрэльба
rockcrete = рокрыт
Sautekh = Саўтэх
Shaken = ашаломлена
Shaken = узрушаны
She Who Thirsts = Прагнучую
Sight = агляд
Sight = Бачнасць
Skimmer = луналая лунач
Slaanesh = Слаанэш
Snot = Снот
Sororitas = Сарорытас
Space Marines = Космапехі
Space Wolves = Касмічных Ваўкоў
Squig = Сквіг
Subvert City = Зрынаньне Горада
T'au = Т'аў
Target = абранай
Target unit = абранай
Terra = Тэрра
The War in Heaven = Нябесная Вайна
Tile = плітка
Tips = падказкі
Tips = рады
Tomb Worlds = Сьветаў Грабніцаў
Traits = Асаблівасьці
Transcendent Bliss = трансцэндэнтальнай асалоды 
Tyranids = Тыраніды
Tzeentch = Тзінч
Ultramarines = Ультрамарынаў (Ультрапехі ?? - але не выкарыстоўваю)
Upgrades = Паляпшэньні
Vehicle = Машына
Warp = Варп
WebwayGate = Шлях павуціньня
Wire Weed = Пустазельля-Дроту
Witchfire = вядзьмарскі агонь
xenos = ксенас
Yield = прыбытак