AI = ШІ
Accuracy = трапнасць
Achievements = Дасягненні
Advanced = Пашыраныя
Aeldari = Аэльдары
Artefact = Артэфакт
Astra Militarum = Астра Мілітарум
Asuryani = Асур'яні
Asuryani = Асур'яні
Asuryani Arrivals = прызыву Асур'яні
Attributes = Уласцівасці
Bark = Дыялог
Basic = Асноўныя
Boon = Дарунак
Broken = зламаны
Cannon = гармата
Chapter = ордэн
Charges = Зарады
Cooldown = Час перазарадкі
Craftworlds = штучных светаў
Deceiver = Ашуканца
Deff (ork) = death
Edicts = Эдыкты
Eldar = Аэльдары
Features = Мясцовасць
For The Greater Good = ў імя найвысокага дабрата
Gun = пушка
Gunship = карабель
Hitpoints = Здароўе
Item = прадмет
Khaine = Кхайна
LifeLeech = Паглынальнік жыцця
Loyalty = лаяльнасць
Maelstrom = Вір
Mark of Nurgle = пазнакай Нургла.
Marks of Chaos = Пазнак Хаосу
Melta = Мельта
Might Makes Right = права моцнага
Morale = мараль
Movement = рух
Necrons = Некроны
Neutral = Нейтрал
Objectives = Мэты
Old Ones = Старажытныя
Omnissiah = Амнісія
Operations = Загады
Orks = Оркі
Player = гулец
Primaris = Прымарыс
RailRifle = рэйка стрэльба
Random = Выпадковая
Rewards = Узнагароды
Rifle = стрэльба
Shaken = узрушаны
Sight = Бачнасць
Slaanesh = Слаанэш
Space Marines = Космадэсант
Subvert City = звяржэнні ў гарадах
T'au = Т'аў
Tile = плітка
Tips = падказкі
Tips = рады
Traits = Асаблівасці
Transcendent Bliss = трансцэндэнтальнай асалоды 
Tyranids = Тыраніды
Tzeentch = Тзінч
Upgrades = Паляпшэнні
Vehicle = Машына
WebwayGate = Шлях павуціння
Wire Weed = Пустазелля-Дроту
Witchfire = вядзьмарскі агонь
Yield = прыбытак
blaster = бластар
cover = хованка
skimmer = луналая
target unit = абранай
sight = агляд
