13th Black Crusade = 13-ты Чорны Крыжовы Паход (падзея)
Abaddon = Аббадон (асоба)
Abominator's Genelab = Генная Лабараторыя Абамінатараў (будынак, Хаос)
Accuracy = Трапнасьць (тэрмін для гульні WH40K Gladius)
Achievements = Дасягненьні (тэрмін для гульні WH40K Gladius)
Adepta Sororitas = Адэпта Сарорытас (фракцыя, Сёстры Бітвы)
Adeptus Astartes = Адэптус Астартэс (фракцыя, Касьмічныя Марыны)
Adeptus Mechanicus = Адэптус Механікус (фракцыя)
Advanced = Пашыраныя (тэрмін для гульні WH40K Gladius)
Aeldari = Аэльдары (фракцыя)
Aeonic = Эанічны (тэрмін)
Aerl Longsight = Аэрл Далёкабачучая (асоба, Аэльдары)
agenda = мэта (тэрмін для гульні WH40K Gladius)
AI = ШІ (тэрмін для гульні WH40K Gladius)
Al-Khemic Quarry = Кар'ер Аль-Хэмік (будынак, Некроны)
Altar to Chaos = Алтар Хаосу (будынак, Хаос)
Altmarl of Vaul = Альтмарл Ваула (будынак, Аэльдары)
Anaris = Анарыс (асабо)
Ancient Enemy = Старажытны Вораг (сінонім Хаосу)
Anointed Hangar = Памазаны Ангар (будынак, Сёстры Бітвы)
Anvil God = Бог Кавадлы (сінонім Ваула)
Apothecarion = Аптэкарыён (будынак)
Archive of the Ways = Архіў Шляхоў (будынак, Хаос)
Archmagos = Архімагас (пасада, Механікус)
Artefact = Артэфакт (тэрмін для гульні WH40K Gladius)
Artisan Constructorum = Майстар Канструкторум (будынак, Механікус)
Astra Militarum = Астра Мілітарум (фракцыя, Гвардыя)
Astronomican = Астраномікан (прадмет, Імперыум)
Astropath = Астрапат (псайкер Імперыума)
Asuryan = Асур'ян (бог, Аэльдары)
Asuryan's Crucible = Тыгель Асур'яна (будынак, Аэльдары)
Asuryani = Асур'яны (сінонім Аэльдары, дзеці Асур'яна)
Asuryani Arrivals = Заклік Асур'яна (гульна)
Attributes = Уласьцівасьці (тэрмін для гульні WH40K Gladius)
Auto-Choral Transmitter = Аўтахаравы Перадатнік (будынак, Механікус)
Auxiliary = Аўксіліарыі (тэрмін, Т'аў)
Avuncular = Сардэчны (сінонім Нургла)
Bark = Дыялог (тэрмін для гульні WH40K Gladius)
Baroque Shrine = Барочны Храм (будынак, Некроны)
Basic = Асноўныя (тэрмін для гульні WH40K Gladius)
Basilica Administratum = Базіліка Адміністратум (будынак, Імперыум)
Basilikon Archaeoptera = Базілікон Археоптара (будынак, Механікус)
Battle Chapel = Баявая Капліца (будынак, Сёстры Бітвы)
Battlesuit = Баявы Гарнітур (тэхналогія, Т'аў)
Bentusin = Бэнтусін (каста Т'аў??)
Big Boss = Буйнабос (тэрмін, Оркі)
bitz = біц (слова паразіт, Оркі)
Black Council = Чорная Рада (тэрмін, Аэльдары)
Black Library = Чорная Бібліятэка (будынак, Аэльдары)
Blaster = бластар (зброя)
Blood Angels = Крывавыя Анёлы (легіён Касьмічных Марынаў)
Blood God = Крывавы Бог (сінонім Кхорна)
Bloodthirster = Крывяпраг (ваяр, Хаосу)
Bloody-Handed God = Крываварукага Бога (сінонім Кхайна)
Bolter Drill = Прарэзьлівыя Болтары (тэрмін)
Bonesinger = Сьпявак Косьці (ваяр, Аэльдары)
Bonesingers Chantry = Капліца Сьпевакоў Косьці (будынак, Аэльдары)
Boon = Дарунак (гульня, Хаос)
Boss Tower = Вежа Боса (будынак, Оркі)
Broken = зламаны (тэрмін для гульні WH40K Gladius)
Brood Mind = Розум Вывадку (тэрмін, Тыраніды)
C'tan = К'тан (бог, Некроны)
C’tan Deceiver = К'тан Ашуканец (бог, Некроны)
Cadia = Кадыя (назва планеты)
Cairn of Ulthanesh = Піраміда Ультанэша (будынак, Аэльдары)
Cannon = гармата (зброя)
Canoptek = канаптэк, канаптэкавы (тэрмін, Некроны)
Canticles of the Omnissiah = Сьпевы Амнісіі (тэрмін, Механікус)
Captive Pens = Загарадзь для Палонных (будынак, Хаос)
Cegorach = Цэгорах (бог, Аэльдары)
Celestine = Сэлесьціна (бог ці сьвятая, Сёстры Бітвы)
Cells Urbis = Вочкі Ўрбіс (будынак, Сёстры Бітвы)
ceramite = Керамітны (тэхналогія)
Changer = Зьменьнік (сінонім Тзіінча)
Chaos Undivided = Хаос Непадзельны (Хаос)
Chapter = Падзел (асобная маленькая падфракцыя Касьміных Марынаў)
Charges = Зарады (тэрмін для гульні WH40K Gladius)
Cherub = Херувім (тэрмін)
chronomancer = хронамант (тэрмін, Некроны)
Chronometron = Хранаметрон (тэрмін, Некроны)
Coalescent = Каалісьцэнцыя (тэрмін, Некроны)
Cogitator Station = Станцыя Кагітацыі (будынак, Імперыум)
comm = ком (камунікацыя, тэрмін)
Commander = Камандор (ваяр, Т'аў)
Commander Surestrike = Камандор Дакладны Ўдар (асоба, Т'аў)
Commandery = Камандорня (будынак, Сёстры Бітвы)
Cooldown = Час перазарадкі (тэрмін для гульні WH40K Gladius)
Coreworlds = Ядравыя Сьветы (тэрмін, Некроны)
Corpse God = Бог Мерцьвяк (сінонім Імператар чалавецтва???)
Cover = хованка (тэрмін для гульні WH40K Gladius)
Craftworlds = Штучны Сьвет (горад, Аэльдары)
creature = стварэньне (тэрмін для гульні WH40K Gladius)
Crone Worlds = Старыя Сьветы (старыя гарады, Аэльдары)
Crownworld = Каронны Сьвет (старыя гарады, Некроны)
Cult Mechanicus = Культ Механікус (будынак, Імперыум)
Cult of Chaos = Культ Хаосу (будынак, Хаос)
Cybork = Кіборк (тэрмін, Оркі)
Daemonhood = Дэманства (тэрмін, Хаос)
daemonkin = дэман-сваяк (Касьмічныя Марыны Хаосу, сінонім брат у звычайных Марынаў)
Dark Angels = Цёмныя Ангелы (легіён Марынаў)
Dark Fortress = Цёмная Крэпасьць (будынак, Хаос)
Dark Gods = Цёмныя Багі (багі Хаосу)
Dark Mechanicum = Цёмны Механікум (тэрмін, Механікус)
Dark Mechanicus = Цёмны Механікус (тэрмін, Механікус)
deathworld’s forecourt = панадворак сьвету сьмерці (тэрмін)
Deceiver = Ашуканец (бог, Некроны)
demonship = карабель-дэман (тэрмін, Хаос)
Departmento Munitorum = Дэпартамент Муніторум (тэрмін, Імперыум)
Destroyer = Разбуральнік (ваяр, Некронаў)
Dialogus Scriptorium = Дыялогус Скрыпторыум (будынак, Сёстры Бітвы)
Diggaz and Smeltaz = Капальні і Плавільні (будынак, Оркі)
Dispense Chaff = Воблака Адбівальнікаў (тэрмін)
Doctrina Imperatives = Дактрыны Імператыў (тэрмін, Механікус)
Dok = Док (ваяр Оркаў)
Dome of the Seers = Купал Празорцаў (будынак, Аэльдары)
Drukhari = Друкхары (фракцыя, Цёмныя Аэльдары)
Ecclesiarchal Reinforcements = Эклізіархальныя Падмацаваньні (будынак, Сёстры Бітвы)
Ecclesiarchy = Эклізіархія (рэлігія Імперыума)
Edicts = Эдыкт (тэрмін, Імперыум)
Eldanesh = Эльданэш (бог, Аэльдары)
Eldar = Аэльдары (фракцыя)
Electromancer = Электрамант (ваяр, Механікус)
Emperor’s Will = Воля Імператара (тэрмін, Імперыум)
Energy Core = Энергетычнае Ядро (будынак, Некроны)
Enrapturess = Захаплесс (асоба, чэмпіён Слаанэша)
Eternity Gate = Брама Вечнасьці (тэрмін, Некроны)
Exodite = Экзадыты, экзадыцкі (фракцыя Аэльдары)
exterminating = экстэрмінацыя, экстэрмініруем (тэрмін, Імперыум)
Exterminatus = Экстэрмінатус (тэрмін, Імперыум)
Extra Bitz = Дадатковыя Шматы (тэрмін, Оркі)
Eye of Terror = Вока Жаху (тэрмін, Хаос)
Fabricator = Фабрыкатар (тэрмін, Механікус) 
Fabricator General = Генерал-Фабрыкатар (тэрмін, Механікус)
Faceeater = тваражэр (тэрмін, Оркі)
Fallen = Палы (тэрмін)
False Emperor = Ілжэімператар (сагласн.), Лжэімператар (галос.) (тэрмін, Хаос)
Famulus Mission = Місія Фамулуса (будынак, Сёстры Бітвы)
Fateweaver = Ткач Лёсу (сінонім Тзіінча)
Features = Мясцовасць (тэрмін для гульні WH40K Gladius)
Ferratonic Furnaces = Фератонныя Печы (будынак, Механікус)
Fighting Pitz = Бойкавыя Ямы (будынак, Оркі)
Fink Tank = Дума Бонд (будынак, Оркі)
first among the Aeldari = Першы Сярод Аэльдары? (тэрмін, Аэльдары)
For the Emperor! = У Імя Імператара! (тэрмін, Імперыум)
For The Greater Good = Ў Імя Найвышэйшага Дабрабыту (тэрмін, Т'аў)
Forbidden Archive = Забаронены Архіў (будынак, Некроны)
Forge Temple = Храм-Кузьня (будынак, Механікус)
Fringeworlds = Межавыя Сьветы (тэрмін, Некроны)
Galvanic = Гальванічны (тэрмін)
gene-seed = генасемя (тэрмін, Марыны)
geneseed = генасемя (тэрмін, Марыны)
Genetor - генетар (тэрмін, Імперыум)
Genetor Caropraedium = Гэнетар Карапраэдзіум (будынак, Механікус)
Ghost Halls = Прывідныя Залы (будынак, Аэльдары)
Gladius Prime = Гладыус Прайм (назва планеты)
God-Emperor = Бог-Імператар (сінонім Імператара чалавецтва)
god—Khaine—fell = Бог - Кхайн Палы (сінонім Кхайна)
Golden Throne = Залаты Трон (тэрмін, Імперыум)
Gork = Горк (бог, Оркі)
Grabbin' Klaw = Клюшня-Хапала (зброя)
Great Devourer = Вялікі Пажыральнік (тэрмін, Тыраніды)
Great Rift = Вялікі Разлом (тэрмін, варп, Хаос)
Greater Good = Найвышэйшы Дабрабыт (тэрмін, Т'аў)
Grot = Грот (ваяр, раса, Оркі)
Grotz Hutz = Хаціны Гротаў (будынак, Оркі)
guidance (chaos) = вядзеньне (тэрмін Хаос)
Guilliman = Гільліман (асоба, прымарх, Імперыум)
Gun = Пушка (тэрмін, зброя)
Gunship = Карабель (тэрмін, ваяр)
Hab Block = Жылблок (будынак, Імперыум)
Hab Fane = Хаб Фэйн (будынак, Механікус)
Haemotrope Reactor = Хіматропны Рэактар (будынак, Механікус)
Harlequins = Арлекіны (тэрмін, Аэльдары)
he who sows dissent = Той, Хто Сее Разлад (сінонім К'тан Ашуканец, бог, Некроны)
Helhaunted Eyrie = Гняздо Хэлдрэйкаў (будынак, Хаос)
HERETEK = Ерэтэх (тэрмін, Хаос, Імперыум)
High Lords of Terra = Найвысокія Лорды Тэры (тэрмін, Імперыум)
Hitpoints = Здароўе (тэрмін для гульні WH40K Gladius)
Hive Cities = Гарад-Вульлей (тэрмін, Імперыум)
Hive Mind = Розум Вульля (тэрмін, Тыраніды)
Hive world = Сьвет-Вулей (тэрмін, Імперыум)
Holophoton = Галафатон (тэрмін, Т'аў)
homeworld = хатні сьвет (тэрмін)
Horus = Хорус (асоба, прымарх, Хаос)
Horus = Хорус (асоба, Хаос)
humies = чылавекі (назва людзей, Оркі)
Hypostyle Temple = Гіпастальны Храм (будынак, Некроны)
Imperial Barracks = Імперскія Жаўнерні (будынак, Імперыум)
Imperial Tarot = Імперскае Таро (тэрмін, Імперыум)
Imperium = Імперыум (фракцыя)
Infernal Fabricator = Пякельны Фабрыкатар (будынак, Хаос)
Ion = Іённы (тэрмін)
Isha = Іша (бог, Аэльдары)
Isha's Gardens = Сады Ішы (будынак, Аэльдары)
Item = Прадмет (тэрмін для гульні WH40K Gladius)
Jackal God = Бог Шакал (сінонім К'тан Ашуканец, бог, Некроны)
jet pack = аэраранец (тэрмін для гульні WH40K Gladius)
jetbike = аэрацыкл (тэрмін для гульні WH40K Gladius)
Kaela Mensha Khaine = Каэла Менша Кхайн (сінонім Кхайн, бог, Аэльдары)
Kastelan = Каштэлян (ваяр, Механікус)
Kauyon = Каён (тэрмін, Т'аў)
Khaine = Кхайн (бог, Аэльдары)
Khorne = Кхорн (бог, Хаос)
Kommando Kamp = Лагір Каммандо (будынак, Оркі)
Kult ov Speed = Культ Хуткасьці (будынак, Оркі)
Kurnous = Карноўс (бог Аэльдары)
Kustom = Кастамны (тэрмін, Оркі)
Labour Corps = Працоўны Корпус (будынак, Імперыум)
Legatines' Priory = Легатынус Прыоры (будынак, Сёстры Бітвы)
Legio Venator = Легіё Венатар (тэрмін, Механікус)
Librarians = Бібліарый (ваяр, Марыны)
Librarium Omnis = Лібрарыум Амніс (будынак, Механікус)
LifeLeech = Паглынальнік Жыцьця (тэрмін для гульні WH40K Gladius)
Llandu'gors = Лланду'гор (бог, Некроны)
Locum = Локум (тэрмін, Механікус)
Long War = Доўгай Вайны (тэрмін, падзея)
Lord of Excess = Валадарка Празьмернасьцяў (сінонім Слаанэш, бог, Хаос)
Lord of Skulls = Валадар Чарапоў (сінонім Кхорн, бог, Хаос)
Lord's Quarters = Пакоі Лордаў (будынак, Хаос)
Loyalty = лаяльнасць (тэрмін для гульні WH40K Gladius)
Lychguard = Гвардыя Ліча (ваяр, Некроны)
Machine god = Бог Машын (сінонім Амнісія, бог, Механікус)
machine spirit = дух машыны (тэрмін, Механікус)
Machine Spirits = Духі Машын (тэрмін, Механікус)
Macragge = Макрагг (назва планеты)
Maelstrom = Вір (вялікі варп-шторм)
Magi = Магі (тэрмін, Механікус)
Magos = Магас (тэрмін, Механікус)
maniples = маніпулы (тэрмін, Механікус)
Manufactorum = Мануфакторум (будынак, Імперыум)
Manufactorum Cybernetica = Мануфакторум Кібернэтыка (будынак, Механікус)
Mark of Nurgle = Пазнака Нургла (тэрмін, Хаос)
Markerlight = Пазначыць Цэлі (тэрмін, Т'аў)
Marks of Chaos = Пазнака Хаосу (тэрмін, Хаос)
Meadow of Sorrow = Луг Жальбы (будынак, Хаос)
Mechatendrils = Мехатэндрылы (тэрмін, Хаос)
Medicus = Медыкус (тэрмін, Імперыум)
megafauna = мегафауна (тэрмін)
Mek Bitz Yard = Двор Шматоў Мекаў (будынак, Оркі)
Mek's Tools = Штукі Мека (тэрмін)
Melta = Мельта (зброя)
Mephet'ran = Мефет'ран (сінонім К'тан Ашуканец, бог, Некроны)
Messenger = Весьнік (сінонім К'тан Ашуканец, бог, Некроны)
Might Makes Right = Моц Дае Права (тэрмін, Оркі)
Ministorum = Міністрорум (тэрмін, Імперыум)
Ministorum Depot = Дэпо Міністорум (будынак, Сёстры Бітвы)
Ministorum Workshop = Майстэрня Міністорум (будынак, Сёстры Бітвы)
Mob = Моб (ваяр, Оркі)
Mont'ka = Монт'ка (тэрмін, Т'аў)
Mont’yhe’va Devourer of Hope = Монт'іхэ'ва - Паглынальнік Надзеі (сінонім Вялікі Разлом, варп-шторм, Т'аў)
Morale = мараль (тэрмін для гульні WH40K Gladius)
Mork = Морк (бог, Оркі)
Movement = рух (тэрмін для гульні WH40K Gladius)
Munitorum Generators = Генератары Муніторума (будынак, Сёстры Бітвы)
Nameless Causeway = Безназоўны Шлях Нагоды (будынак, Некроны)
Narthecium = Нартэцыум (тэрмін)
Necrodermis = Некрадэрміс (тэрмін, Некроны)
Necrons = Некроны (фракцыя)
Necrontyr = Некрантыр (родная планета Некронаў)
Neutral = Нейтрал (тэрмін для гульні WH40K Gladius)
Nova Boost = Нова Паскарэньне (тэрмін, Т'аў)
Nurgle = Нургл (бог, Хаос)
Objectives = Мэты (тэрмін для гульні WH40K Gladius)
Officio Tactica = Афіцыё Тактыка (будынак, Імперыум)
Old Ones = Старажытныя (фракцыя)
Omniscience = Амнінавука (тэрмін, Механікус)
Omnissiah = Амнісія (бог, Механікус)
Operations = Аперацыі (тэрмін, Імперыум)
Ordnance = Артылерыя (тэрмін)
Ordo Malleus = Орда Мальлеўс (фракцыя, Імперыум, Інквізіцыя)
Ore Extractor = Экстрактар Руды (будынак, Імперыум)
Orks = Оркі (фракцыя)
Paroxysm = Параксізм (тэрмін, Тыраніды)
Path of the Outcast = Шлях Адрынутых (тэрмін, Аэльдары)
Pile O' Dakka = Куча Во'Дакка (будынак, Оркі)
Pinning = скоўваньня (тэрмін для гульні WH40K Gladius)
Plasma Ioniser = Іянізатар (будынак, Імперыум)
plasteel = пласталь, пластальны (тэрмін, матэрыял)
Player = гулец (тэрмін для гульні WH40K Gladius)
Portal Spire = Партал-Шпіль (будынак, Аэльдары)
Powwa Gubbinz = Габбінз Моцыыы (будынак, Оркі)
Preceptory = Прэцэпторыя (будынак, Сёстры Бітвы)
Primaris = Прымарыс (тэрмін, Марыны)
Progenitor = Прабацька (тэрмін, Тыраніды)
Projected Void Shield = Праекцыйны Пустэчны Шчыт (тэрмін)
Pronatus Reliquary = Пронатус Рэліквары (будынак, Сёстры Бітвы)
Protoservitor Cradle = Калыска Протасэрвітараў (будынак, Механікус)
Psyker Coven = Ковен Псайкераў (будынак, Імперыум)
Quaestos Mechanicor = Квэстас Механікар (тэрмін, Механікус)
Questoris Mechanicus = Квэсторыс Механікус (тэрмін, Механікус)
Rad Saturation = Радыянасычанасьць (тэрмін, Механікус)
RailRifle = рэйкавая стрэльба (зброя)
Random = Выпадковая (тэрмін для гульні WH40K Gladius)
Red Wunz Go Fasta = Чырвонае Руша Шпарка (тэрмін, Оркі)
Renderer = Рэндэрар (будынак, Хаос)
Rewards = Узнагароды (тэрмін для гульні WH40K Gladius)
Rifle = стрэльба (зброя)
Rinyon = Рыньён (тэрмін, Т'аў)
Rip'yka = Рып'айка (тэрмін, Т'аў)
rockcrete = рокрыт, рокрыцкі (тэрмін, матэрыял)
Rogal Dorn = Рогал Дорн (асобы, прымарх Марыны)
Royal Court = Гаспадарскі Палац (будынак, Некроны)
Royal Pyramid = Гаспадарская Піраміда (будынак, Некроны)
Runtherd = Паганяты (ваяр, Оркі)
Runtherd Groundz = Загон Паганятых (будынак, Оркі)
Sanctum Imperialis = Санктум Імперыаліс (будынак, Імперыум)
Sautekh = Саўтэх (фракцыя, Некроны)
Scrap Shedz = Павеці Ламачча (будынак, Оркі)
Seer = Празорца (ваяр, Аэльдары)
senior Imperial administrator = Імперскі сеньёр-адміністратар (пасада, Імперыум)
servitors = сэрвітараў (ваяр, Імперыум)
Servo-Skull = Сэрвачэрап (тэрмін, Механікус)
Shadow In The Warp = Цень у Варпе (тэрмін, Тыраніды)
Shaken = Узрушаны (тэрмін для гульні WH40K Gladius)
She Who Thirsts = Яна-Прагнучая / Прагнучая / Яна, Што Прагне / Яна, якая Прагне (сінонім Слаанэш, бог, Хаос)
Shelters = Сховішчы (будынак, Некроны)
Shrine of Khaine = Храм Кхайна (будынак, Аэльдары)
Shrine of the Aquila = Храм Аквілы (будынак, Імперыум)
Sight = агляд (тэрмін для гульні WH40K Gladius)
Silent King = Маўклівы Валадар (сінонім Сзарэх, асоба Некроны)
Skimmer = Лунач, Лунальнік, Луналы (тэрмін, тып адзінкі)
Slaanesh = Слаанэш (бог, Хаос)
Slave Mastaba = Мастаба Рабоў (будынак, Некроны)
Slave Mines = Рабскія Капальні (будынак, Хаос)
Snot = Снот (ваяр, Оркі)
Solitaire = Салітар (ваяр, Аэльдары, Арлекіны)
Sororitas = Сарорытас (фракцыя, Імперыум)
Soylen = Сойлен (тэрмін, ежа, Імперыум)
Soylens Farm = Ферма Сойлена (будынак, Імперыум)
space hulk = касьмічная грамадзіна (тэрмін)
Space Marines = Касьмічныя Марыны, Космамарыны (фракцыя, Імперыум)
Space Wolves = Касьмічных Ваўкоў (легіён, фракцыя, Марыны)
Spirit Ossuary = Склеп Душ (будынак, Аэльдары)
Squig = Сквіг (істота, ваяр, Оркі)
Squig Herdz = Статак Сквігаў (будынак, Оркі)
Star God = Зорны Бог (сінонім К'тан, бог, Некроны)
Stealth Field = Шчыт-Нябачнік (тэрмін, Т'аў)
Stelae = Стэла (будынак, Некроны)
Sub-Cloister = Падманастыр (будынак, Механікус)
Subvert City = Зрынаньне Горада (здольнасьць, Т'аў)
Subvert City = Зрынаньне Горада (тэрмін, Т'аў)
Suin Daellae = Суін Даэллае (меч аватара Кхайна)
Summoning Core = Ядро Закліку (будынак, Некроны)
swarm-god = бог рою (сінонім Нургла, бог, Хаос)
Synapse Link = Сувязь Сінапсу (тэрмін, Тыраніды)
Szarekh = Сзарэх (асоба, Некроны)
T'au = Т'аў (фракцыя)
tallymen = празмерны (ваяр, Касьмічныя Марыны Хаосу)
Target = абранай (тэрмін для гульні WH40K Gladius)
Target unit = абранай (тэрмін для гульні WH40K Gladius)
Tech-Adept = Тэхадэпт (тэрмін, Механікус)
Techmarine = Тэхнамарын (ваяр, Марыны)
Terra = Тэрра (планета)
The War in Heaven = Нябесная Вайна (падзея)
Thermo Plasma Generator = Генератар Тэрмаплазмы (будынак, Аэльдары)
Thermo-Exchanger Shrine = Храм Тэрмапамену" (будынак, Механікус)
Tiamet = Ціамет (фракцыя, Тыраніды, Флот Вулей)
Tile = плітка (тэрмін для гульні WH40K Gladius)
tin'edz = цін'эдз (слова, Оркі, назва Некронаў)
Tips = падказкі (тэрмін для гульні WH40K Gladius)
Tomb Worlds = Сьвет-Грабніца (тэрмін, Некроны)
Traits = Асаблівасьці (тэрмін для гульні WH40K Gladius)
Transcendent Bliss = Трансцэндэнтальная Асалода (тэрмін, Некроны)
Tyranids = Тыраніды (фракцыя)
Tzeentch = Тзіінч (бог, Хаос)
Ulthanesh = Ультанэш (бог, Аэльдары)
Ultramarines = Ультрамарыны (фракцыя, Марыны)
Unnamed herself = Сама Безыменная (сінонім Слаанэш у Аэльдары, бог, Хаос,)
Upgrades = Паляпшэньні (тэрмін для гульні WH40K Gladius)
Vandire = Вандзіра (асоба, Сёстры Бітвы)
Vaul = Ваул (бог, Аэльдары)
Vehicle = Машына (тэрмін для гульні WH40K Gladius)
Voidport = Пустэчны Порт (будынак, Імперыум)
Volley Fire = Залпавы Агонь (тэрмін, Т'аў)
Waaagh = Вааагх (тэрмін, Оркі)
War in Heaven = Вайна на Нябёсах (падзея)
warband = вайсковая банда (тэрмін, Хаос)
Warmaster = Майстар Вайны (тэрмін, Імперыум, Хаос, досыць часта сінонім Хорус)
Warp = Варп (тэрмін)
Warp Forge = Варп-Кузьня (будынак, Хаос)
Warpbound Generator = Генератар Злучаны з Варпам (будынак, Хаос)
Webway Redoubt = Рэдут Павуціньня (будынак, Аэльдары)
WebwayGate = Шлях Павуціньня (тэрмін, Аэльдары, Старажытныя)
Weirdboyz Pole = Слуп Дзівахлопца (будынак, Оркі)
Wire Weed = Пустазельле-Дрот (тэрмін для гульні WH40K Gladius)
Witchfire = вядзьмарскі агонь (тэрмін для гульні WH40K Gladius)
World Spirit = Сусветны Дух (тэрмін, Аэльдары)
Wossat = Шоэта (слова, Оркі)
wraithbone = прывідная костка (матэрыял, Аэльдары)
xenos = ксенас (тэрмін)
Yield = прыбытак (тэрмін для гульні WH40K Gladius)
Yngir—the C’tan = К'тан Інгір (сінонім К'тан Ашуканец у Аэльдары, бог, Некроны)
Young King = Малады Гаспадар (пасада, Аэльдары)
Zephyr = Зефір (ваяр, Т'аў)
Zog = Зог (слова паразіт, Оркі)
Zogging  = Зогавы (слова паразіт, Оркі)